0 -    Empty
1 -     Wall
3 -  Powerup - 100 % chance
4 -     Coin - 50  % chance
5 -     Coin - 100 % chance
6 -      Ice - 100 % chance
7 - Teleport - 100 % chance
8 -    Steel - 100 % chance
9 -   Magnet - 100 % chance

Dimensions:
Row    Length: 40
Column Length: Depends

DRAW FROM PLAYER PERSPECTIVE - DOWN-UP

LEAVE 1 ROW AT THE START AND END

First 2 numbers:
number of paterns that must come before
frequency

START
0
40
0000000000000000000000000000000000000000
1111111111111110000000000111111111111111
0000000000000000000000000000000000000000
0000000000000000000000000000000000000000
0000000000000000000000000000000000000000
0000000000000001111111111000000000000000
0000000000000000000000000000000000000000
0000000000000000000000000000000000000000
0000000000000000000000000000000000000000
1111111111111110000440000111111111111111
0000000000000000000000000000000000000000
0000000000000000000000000000000000000000
0000000000000000000000000000000000000000
0000000000000001111111111000000000000000
0000000000000000000000000000000000000000
END

START
0
20
0000000000000000000000000000000000000000
0000000000111111111111111111111111111111
0000000000000000000000000000000000000000
0000000000000000000000000000000000000000
0000000000000000000000000000000000000000
1111111111111111111111111111110000000000
0000000000000000000000000000000000000000
0000000000000000000000000000000000000000
0000000000000000000000000000000000000000
0000000000111111111111111111111111111111
0000000000000000000000000000000000000000
0000000000000000000000000000000000000000
0000000000000000000000000000000000000000
1111111111111111111111111111110000000000
0000000000000000000000000000000000000000
END

START
0
30
0000000000000000000000000000000000000000
1111111111111111111111111111110000000000
0000000000000000000000000000000000000000
0000000000000000000000000000000000000000
0000000000000000000000000000000000000000
1111111111000000000011111111111111111111
0000000000000000000000000000000000000000
0000000000000000000000000000000000000000
0000000000000000000000000000000000000000
1000000000011111111111111111111111111111
0000000000000000000000000000000000000000
0000000000000000000000000000000000000000
0000000000000000000000000000000000000000
1111111111111111111111111111110000000000
0000000000000000000000000000000000000000
END

START
0
40
0000000000000000000000000000000000000000
0000000011111111111111111111111100000000
0000000000000000000000000000000000000000
0000000000000000000000000000000000000000
0000000000000000000000000000000000000000
1111111111111111000000001111111111111111
0000000000000000000000000000000000000000
0000000000000000000000000000000000000000
0000000000000000000000000000000000000000
0000000011111111111111111111111100000000
0000000000000000000000000000000000000000
0000000000000000000000000000000000000000
0000000000000000000000000000000000000000
1111111111111111000000001111111111111111
0000000000000000000000000000000000000000
END

START
0
20
0000000000000000000000000000000000000000
1111111111000001111111111000001111111111
0000000000000000000000000000000000000000
0000000000000000000000000000000000000000
0000000000000000000000000000000000000000
0000000011111111100000011111111100000000
0000000000000000000000000000000000000000
0000000000000000000000000000000000000000
0000000000000000000000000000000000000000
1111111111000001111111111000001111111111
0000000000000000000000000000000000000000
0000000000000000000000000000000000000000
0000000000000000000000000000000000000000
0000000011111111100000011111111100000000
0000000000000000000000000000000000000000
END

START
4
40
0000000000000000000000000000000000000000
0000000001000000000010000000010000000000
0000000001000000000010000000010000000000
0000000001000000000010000000010000000000
0000000001000000000010000000010000000000
0000000001000000000010000000011111111111
0000000001111111111110000000000000000000
0000000000000000000100000000000000000000
0000000000000000000100000000000000000000
0000000000000000000111111111111000000000
1111111111100000000100000000001000000000
0000000000100000000100000500001000000000
0000000000100000000100000000001000000000
0000000000000000000000000000000000000000
END

START
4
40
0000000000000000000000000000000000000000
0000000000100000000100000000001000000000
0000000000100000000100000000001000000000
0000000000100000000100003000001000000000
0000000000100000000100000000001000000000
1111111111100000000100000000001000000000
0000000000000000000111111111111000000000
0000000000000000000010000000000000000000
0000000000000000000010000000000000000000
0000000001111111111110000000000000000000
0000000001000000000010000000011111111111
0000000001000050000010000000010000000000
0000000001000000000010000000010000000000
0000000000000000000000000000000000000000
END

START
4
40
0000000000000000000000000000000000000000
0000000000000011111111111111111111111111
0000000000000010000000000001000000000000
0000000000000010000000000001000000000000
0000000000000010000000000001000000000000
0000000000000010000001000001000000100000
0000000000000010000001000001000000100000
0000000000000010000001000001000000100000
0000000000000010000001000001000000100000
0000000000000010000001000000000000100000
0000000000000010000001000004000000100000
0000000000000010000001000000000000100000
0000000000000000000001111111111111100000
0000000000000000000000000000000000100000
0000000000000000000000000000000300100000
0000000000000000000000000000000000100000
1111111111111111111111111111111111100000
0000000000000000000000000000000000000000
END

START
8
30
0000000000000000000000000000000000000000
1111111111111111111111111111111111000000
0000000000000000000000000000000000000000
0000000000000000000000000000000000000000
0000000000000000000000000000000000000000
0000001111111111111111111111111111000000
0000000000000001000000000000100000000000
0000000000000001004000000000100000000000
0000000000000001000000000000100000000000
0000000000000001111111000000000000111111
0000001000000000000001000000000000000000
0000001000000000000001000000000000000000
0000001000000000000001000000000000000000
0000001111111111000001111111111111100000
0000000000000001000001000000000000100000
0000000000030001000001000000000000100000
0000000000000001000001000000000000100000
1111111111111111000000000001000000000000
0000000000000000000000000001000000000000
0000000000000000000000000001000000000000
0000000000000000000000000001000000000000
0000001111111111111111111111111111111111
0000000000000000000000000000000000000000
END

START
8
30
0000000000000000000000000000000000000000
0000001111111111111111111111111111111111
0000000000000000000000000000000000000000
0000000000000000000000000000000000000000
0000000000000000000000000000000000000000
0000001111111111111111110000011111000000
0000001000001000000000000000000001000000
0000001000001000000000000000000001000000
0000001000001000000000000000000001000000
0000000000001111111111111111000001000000
0000000000001000000000000000000001000000
0000000000001000000000000000000001000000
0000000000001000000000000000000001000000
1111111111111000001111111111111111111111
0000000000001000000000000000000001000000
0000000000001000000000000000000001000000
0000000000001000000000000000000001000000
0000000000001111111111111111000001000000
0000001000001000000000000000000001000000
0000001004001000000000000000000001000000
0000001000001000000000000000000001000000
0000001111111111111111110000011111000000
0000000000000000000000000000000000000000
0000000000000000000000000000000000000000
0000000000000000000000000000000000000000
0000001111111111111111111111111111111111
0000000000000000000000000000000000000000
END

START
12
30
0000000000000000000000000000000000000000
0000000011111111111111111111111111111111
0000000000000000000000001000000000000100
0000000000000000000000001000000000000100
0000000000000000000000001000000000000100
1111111111111111110000001000000100000100
0000000000000000000000001000000100000100
0004000000000000000000001000000100000100
0000000000000000000000001000000100000100
1111111111100000010000001000000100000100
0000000000100000010000001000000100000100
0000000000100000010000000000000100000100
0000100000100000010000000000000100000100
0000104340100000010000000000000100000100
0000100000100000011111111111111100000100
0000111111100000010000000000000000000100
0000000000000000010000000000000000000100
0000000000000000010000000000000000000100
0000000000000000010000000000100000000100
1111111111111111111111000000111111111100
0000000000000000000000000000000000000000
END

START
5
50
0000000000000000000000000000000000000000
0011001100110011001100110011001110011011
0000000000000000000000000000000000000000
1100110011001100110011001100110011100110
0000000000000000000000000000000000000000
0011001100110011001100110011001110011011
0000000000000000000000000000000000000000
1100110011001100110011001100110011100110
0000000000000000000000000000000000000000
0011001100110011001100110011001110011011
0000000000000000000000000000000000000000
1100110011001100110011001100110011100110
0000000000000000000000000000000000000000
0011001100110011001100110011001110011011
0000000000000000000000000000000000000000
1100110011001100110011001100110011100110
0000000000000000000000000000000000000000
0011001100110011001100110011001110011011
0000000000000000000000000000000000000000
1100110011001100110011001100110011100110
0000000000000000000000000000000000000000
END









