0 - Empty
1 - Wall
2 - Player (Do not put player in)
3 - Powerup

Dimensions:
Row Length: 40
Column Length: Depends

DRAW FROM PLAYER PERSPECTIVE - DOWN-UP

LEAVE 1 ROW AT THE START AND END

START
0000000000000000000000000000000000000000
1111111111111110000000000111111111111111
0000000000000000000000000000000000000000
0000000000000000000000000000000000000000
0000000000000000000000000000000000000000
0000000000000001111111111000000000000000
0000000000000000000000000000000000000000
0000000000000000000000000000000000000000
0000000000000000000000000000000000000000
1111111111111110000000000111111111111111
0000000000000000000000000000000000000000
0000000000000000000000000000000000000000
0000000000000000000000000000000000000000
0000000000000001111111111000000000000000
0000000000000000000000000000000000000000
END

START
0000000000000000000000000000000000000000
0000000000111111111111111111111111111111
0000000000000000000000000000000000000000
0000000000000000000000000000000000000000
0000000000000000000000000000000000000000
1111111111111111111111111111110000000000
0000000000000000000000000000000000000000
0000000000000000000000000000000000000000
0000000000000000000000000000000000000000
0000000000111111111111111111111111111111
0000000000000000000000000000000000000000
0000000000000000000000000000000000000000
0000000000000000000000000000000000000000
1111111111111111111111111111110000000000
0000000000000000000000000000000000000000
END


START
0000000000000000000000000000000000000000
0000000011111111111111111111111100000000
0000000000000000000000000000000000000000
0000000000000000000000000000000000000000
0000000000000000000000000000000000000000
1111111111111111000000001111111111111111
0000000000000000000000000000000000000000
0000000000000000000000000000000000000000
0000000000000000000000000000000000000000
0000000011111111111111111111111100000000
0000000000000000000000000000000000000000
0000000000000000000000000000000000000000
0000000000000000000000000000000000000000
1111111111111111000000001111111111111111
0000000000000000000000000000000000000000
END

START
0000000000000000000000000000000000000000
0000000001100000000110000000011000000000
0000000001100000000110000000011000000000
0000000001100030000110000000011000000000
0000000001100000000110000000011000000000
0000000001100000000110000000011111111111
0000000001111111111110000000000000000000
0000000000000000000110000000000000000000
0000000000000000000110000000000000000000
0000000000000000000111111111111000000000
1111111111100000000110000000011000000000
0000000001100000000110000000011000000000
0000000001100000000110000000011000000000
0000000000000000000000000000000000000000
END








