0 - Empty
1 - Wall
2 - Player
3 - Powerup
4 - Coin

Dimensions:
Row Length: 40
Column Length: Depends

DRAW FROM PLAYER PERSPECTIVE - DOWN-UP

LEAVE 1 ROW AT THE START AND END

START
0000000000000000000000000000000000000000
1111111111111110000000000111111111111111
0000000000000000000000000000000000000000
0000000000000000000000000000000000000000
0000000000000000000000000000000000000000
0000000000000001111111111000000000000000
0000000000000000000000000000000000000000
0000000000000000000000000000000000000000
0000000000000000000000000000000000000000
1111111111111110000000000111111111111111
0000000000000000000000000000000000000000
0000000000000000000000000000000000000000
0000000000000000000000000000000000000000
0000000000000001111111111000000000000000
0000000000000000000000000000000000000000
END

START
0000000000000000000000000000000000000000
0000000000111111111111111111111111111111
0000000000000000000000000000000000000000
0000000000000000000000000000000000000000
0000000000000000000000000000000000000000
1111111111111111111111111111110000000000
0000000000000000000000000000000000000000
0000000000000000000000000000000000000000
0000000000000000000000000000000000000000
0000000000111111111111111111111111111111
0000000000000000000000000000000000000000
0000000000000000000000000000000000000000
0000000000000000000000000000000000000000
1111111111111111111111111111110000000000
0000000000000000000000000000000000000000
END


START
0000000000000000000000000000000000000000
0000000011111111111111111111111100000000
0000000000000000000000000000000000000000
0000000000000000000000000000000000000000
0000000000000000000000000000000000000000
1111111111111111000000001111111111111111
0000000000000000000000000000000000000000
0000000000000000000000000000000000000000
0000000000000000000000000000000000000000
0000000011111111111111111111111100000000
0000000000000000000000000000000000000000
0000000000000000000000000000000000000000
0000000000000000000000000000000000000000
1111111111111111000000001111111111111111
0000000000000000000000000000000000000000
END

START
0000000000000000000000000000000000000000
0000000001000000000010000000010000000000
0000000001000000000010000000010000000000
0000000001000000000010000000010000000000
0000000001000000000010000000010000000000
0000000001000000000010000000011111111111
0000000001111111111110000000000000000000
0000000000000000000100000000000000000000
0000000000000000000100000000000000000000
0000000000000000000111111111111000000000
1111111111100000000100000000001000000000
0000000000100000000100000300001000000000
0000000000100000000100000000001000000000
0000000000000000000000000000000000000000
END

START
0000000000000000000000000000000000000000
0000000000100000000100000000001000000000
0000000000100000000100000000001000000000
0000000000100000000100000300001000000000
0000000000100000000100000000001000000000
1111111111100000000100000000001000000000
0000000000000000000111111111111000000000
0000000000000000000010000000000000000000
0000000000000000000010000000000000000000
0000000001111111111110000000000000000000
0000000001000000000010000000011111111111
0000000001000000000010000000010000000000
0000000001000000000010000000010000000000
0000000000000000000000000000000000000000
END

START
0000000000000000000000000000000000000000
0000100001000010000100001000010000100001
0001000010000100001000010000100001000010
0001000010000100001000010000100001000010
0001000010000100001000010000100001000010
0001000010000100001000010000100001000010
0010000100001000010000100001000010000100
0010000100001000010000100001000010000100
0010000100001000010000100001000010000100
0010000100001000010000100001000010000100
0100001000010000100001000010000100001000
0100001000010000100001000010000100001000
0100001000010000100001000010000100001000
0100001000010000100001000010000100001000
1000010000100001000010000100001000010000
1000010000100001000010000100001000010000
1000010000100001000010000100001000010000
1000011111111111111111111111111111111111
0000000000000000000000000000000000000000
END

START
0000000000000000000000000000000000000000
0000100001000010000100001000010000100001
0001000010000100001000010000100001000010
0001000010000100001000010000100001000010
0001000010000100001000010000100001000010
0001000010000100001000010000100001000010
0010000100001000010000100001000010000100
0010000100001000010000100001000010000100
0010000100001000010000100001000010000100
0010000100001000010000100001000010000100
0100001000010000100001000010000100001000
0100001000010000100001000010000100001000
0100001000010000100001000010000100001000
0100001000010000100001000010000100001000
1000010000100001000010000100001000010000
1000010000100001000010000100001000010000
1000010000100001000010000100001000010000
1111110000111111111111111111111111111111
0000000000000000000000000000000000000000
END

START
0000000000000000000000000000000000000000
0000100001000010000100001000010000100001
0001000010000100001000010000100001000010
0001000010000100001000010000100001000010
0001000010000100001000010000100001000010
0001000010000100001000010000100001000010
0010000100001000010000100001000010000100
0010000100001000010000100001000010000100
0010000100001000010000100001000010000100
0010000100001000010000100001000010000100
0100001000010000100001000010000100001000
0100001000010000100001000010000100001000
0100001000010000100001000010000100001000
0100001000010000100001000010000100001000
1000010000100001000010000100001000010000
1000010000100001000010000100001000010000
1000010000100001000010000100001000010000
1111111111100001111111111111111111111111
0000000000000000000000000000000000000000
END

START
0000000000000000000000000000000000000000
0000100001000010000100001000010000100001
0001000010000100001000010000100001000010
0001000010000100001000010000100001000010
0001000010000100001000010000100001000010
0001000010000100001000010000100001000010
0010000100001000010000100001000010000100
0010000100001000010000100001000010000100
0010000100001000010000100001000010000100
0010000100001000010000100001000010000100
0100001000010000100001000010000100001000
0100001000010000100001000010000100001000
0100001000010000100001000010000100001000
0100001000010000100001000010000100001000
1000010000100001000010000100001000010000
1000010000100001000010000100001000010000
1000010000100001000010000100001000010000
1111111111111111000011111111111111111111
0000000000000000000000000000000000000000
END

START
0000000000000000000000000000000000000000
0000100001000010000100001000010000100001
0001000010000100001000010000100001000010
0001000010000100001000010000100001000010
0001000010000100001000010000100001000010
0001000010000100001000010000100001000010
0010000100001000010000100001000010000100
0010000100001000010000100001000010000100
0010000100001000010000100001000010000100
0010000100001000010000100001000010000100
0100001000010000100001000010000100001000
0100001000010000100001000010000100001000
0100001000010000100001000010000100001000
0100001000010000100001000010000100001000
1000010000100001000010000100001000010000
1000010000100001000010000100001000010000
1000010000100001000010000100001000010000
1111111111111111111110000111111111111111
0000000000000000000000000000000000000000
END

START
0000000000000000000000000000000000000000
0000100001000010000100001000010000100001
0001000010000100001000010000100001000010
0001000010000100001000010000100001000010
0001000010000100001000010000100001000010
0001000010000100001000010000100001000010
0010000100001000010000100001000010000100
0010000100001000010000100001000010000100
0010000100001000010000100001000010000100
0010000100001000010000100001000010000100
0100001000010000100001000010000100001000
0100001000010000100001000010000100001000
0100001000010000100001000010000100001000
0100001000010000100001000010000100001000
1000010000100001000010000100001000010000
1000010000100001000010000100001000010000
1000010000100001000010000100001000010000
1111111111111111111111111100001111111111
0000000000000000000000000000000000000000
END

START
0000000000000000000000000000000000000000
0000100001000010000100001000010000100001
0001000010000100001000010000100001000010
0001000010000100001000010000100001000010
0001000010000100001000010000100001000010
0001000010000100001000010000100001000010
0010000100001000010000100001000010000100
0010000100001000010000100001000010000100
0010000100001000010000100001000010000100
0010000100001000010000100001000010000100
0100001000010000100001000010000100001000
0100001000010000100001000010000100001000
0100001000010000100001000010000100001000
0100001000010000100001000010000100001000
1000010000100001000010000100001000010000
1000010000100001000010000100001000010000
1000010000100001000010000100001000010000
1111111111111111111111111111111000011111
0000000000000000000000000000000000000000
END