0 - Empty
1 - Wall
2 - Player
3 - Powerup

Dimensions:
Row Length: 40
Column Length: Depends

DRAW FROM PLAYER PERSPECTIVE - DOWN-UP

START
0000000000000000000000000000000000000000
0000000000000000000000000000000000000000
1111111111111110000000000111111111111111
0000000000000000000000000000000000000000
0000000000000000000000000000000000000000
0000000000000001111111111000000000000000
0000000000000000000000000000000000000000
0000000000000000000000000000000000000000
1111111111111110000000000111111111111111
0000000000000000000000000000000000000000
END