0 -   Empty
1 -    Wall
2 - Powerup - 50  % chance
3 - Powerup - 100 % chance
4 -    Coin - 50  % chance
5 -    Coin - 100 % chance
6 -   Fwall - A fake wall

Dimensions:
Row    Length: 40
Column Length: Depends

DRAW FROM PLAYER PERSPECTIVE - DOWN-UP

LEAVE 1 ROW AT THE START AND END

First 2 numbers:
number of paterns that must come before
frequency

START
0
4
0000000000000000000000000000000000000000
1111111111111110000000000111111111111111
0000000000000000000000000000000000000000
0000000000000000000000000000000000000000
0000000000000000000000000000000000000000
0000000000000001111111111000000000000000
0000000000000000000000000000000000000000
0000000000000000000000000000000000000000
0000000000000000000000000000000000000000
1111111111111110000440000111111111111111
0000000000000000000000000000000000000000
0000000000000000000000000000000000000000
0000000000000000000000000000000000000000
0000000000000001111111111000000000000000
0000000000000000000000000000000000000000
END

START
0
4
0000000000000000000000000000000000000000
0000000000111111111111111111111111111111
0000000000000000000000000000000000000000
0000000000000000000000000000000000000000
0000000000000000000000000000000000000000
1111111111111111111111111111110000000000
0000000000000000000000000000000000000000
0000000000000000000000000000000000000000
0000000000000000000000000000000000000000
0000000000111111111111111111111111111111
0000000000000000000000000000000000000000
0000000000000000000000000000000000000000
0000000000000000000000000000000000000000
1111111111111111111111111111110000000000
0000000000000000000000000000000000000000
END


START
0
4
0000000000000000000000000000000000000000
0000000011111111111111111111111100000000
0000000000000000000000000000000000000000
0000000000000000000000000000000000000000
0000000000000000000000000000000000000000
1111111111111111000000001111111111111111
0000000000000000000000000000000000000000
0000000000000000000000000000000000000000
0000000000000000000000000000000000000000
0000000011111111111111111111111100000000
0000000000000000000000000000000000000000
0000000000000000000000000000000000000000
0000000000000000000000000000000000000000
1111111111111111000000001111111111111111
0000000000000000000000000000000000000000
END

START
4
4
0000000000000000000000000000000000000000
0000000001000000000010000000010000000000
0000000001000000000010000000010000000000
0000000001000000000010000000010000000000
0000000001000000000010000000010000000000
0000000001000000000010000000011111111111
0000000001111111111110000000000000000000
0000000000000000000100000000000000000000
0000000000000000000100000000000000000000
0000000000000000000111111111111000000000
1111111111100000000100000000001000000000
0000000000100000000100000500001000000000
0000000000100000000100000000001000000000
0000000000000000000000000000000000000000
END

START
4
4
0000000000000000000000000000000000000000
0000000000100000000100000000001000000000
0000000000100000000100000000001000000000
0000000000100000000100000300001000000000
0000000000100000000100000000001000000000
1111111111100000000100000000001000000000
0000000000000000000111111111111000000000
0000000000000000000010000000000000000000
0000000000000000000010000000000000000000
0000000001111111111110000000000000000000
0000000001000000000010000000011111111111
0000000001000050000010000000010000000000
0000000001000000000010000000010000000000
0000000000000000000000000000000000000000
END

START
4
4
0000000000000000000000000000000000000000
0000000000000011111111111111111111111111
0000000000000010000000000001000000000001
0000000000000010000000000001000000000001
0000000000000010000000000001000000000001
0000000000000010000001000001000000100001
0000000000000010000001000001000000100001
0000000000000010000001000001000000100001
0000000000000010000001000001000000100001
0000000000000010000001000000000000100001
0000000000000010000001000004000000100001
0000000000000010000001000000000000100001
0000000000000000000001111111111111100001
0000000000000000000000000000000005100001
0000000000000000000000000000000005100001
1111111111111111111111111111111111100001
0000000000000000000000000000000000000000
END