0 - Empty
1 - Wall
2 - Player
3 - Powerup

Dimensions:
Row Length: 40
Column Length: Depends

DRAW FROM PLAYER PERSPECTIVE - DOWN-UP

START
0000000000000000000000000000000000000000
0000000000000000000000000000000000000000
1111111111111110000000000111111111111111
0000000000000000000000000000000000000000
0000000000000000000000000000000000000000
0000000000000000000000000000000000000000
0000000000000001111111111000000000000000
0000000000000000000000000000000000000000
0000000000000000000000000000000000000000
0000000000000000000000000000000000000000
1111111111111110000000000111111111111111
0000000000000000000000000000000000000000
0000000000000000000000000000000000000000
END

.START
0000000000000000000000000000000000000000
0000000000000000000000000000000000000000
1101100000000000000000000000000000000000
0001111111111111111111111110111111111111
0011111000000000000000000000111111311111
1001111011111111111111111111111111011111
0011100011000100010001000100010001013111
1001100111010101010101010101010101010111
1100110000010001000100010001000100000031
0001111111111111111111111111111111111111
0000000000000000000000000000000000000000
0000000000000000000000000000000000000000
.END


